WWWWWWWWWWWWWWWWWWWW
WWWWWWWWWWWWWWWWWWWW
WWWWWWWWWW     WWWWW
WWWWWWWWWW     WWWWW
WWWWWWWWWWWW   WWWWW
WWWWWWWWWWWW   WWWWW
WWWWWWWWWWWW   WWWWW
WWWWWWWWWWWW   WWWWW
WWWWW          WWWWW
WWWWW   WWWWWWWWWWWW
WWWWW   WWWWWWWWWWWW
WWWWW   WWWWWWWWWWWW
WWWWWW         WWWWW
WWWWWWWWWWWWWWWWWWWW
